#######
#**...#
#\*...#
# #...#
#    R#
#####L#