###########################################################################################################
#........................................................................................................\#
#..\\###...#....        ###..\\###...#....        ###..\\###...#....        ###..\\###...#....        ###.#
#..\*\\\.. #.... ..##\\..\#..\*\\\.. #.... ..##\\..\#..\*\\\.. #.... ..##\\..\#..\*\\\.. #.... ..##\\..\#.#
#..\*\.... #.... ..#\#....#..\*\.... #.... ..#\#....#..\*\.... #.... ..#\#....#..\*\.... #.... ..#\#....#.#
#...\###.. #.... ....#....#...\###.. #.... ....#....#...\###.. #.... ....#....#...\###.. #.... ....#....#.#
#... ..... ..... .####........ ..... ..... .####........ ..... ..... .####........ ..... ..... .####......#
#\\. #....           ......\\. #....           ......\\. #....           ......\\. #....           .......#
#... #..#. .....*\ ##......... #..#. .....*\ ##......... #..#. .....*\ ##......... #..#. .....*\ ##.......#
#.#....... ...#..  ....####.#....... ...#..  ....####.#....... ...#..  ....####.#....... ...#..  ....######
#. ...#... ...#.\  ....#..*. ...#... ...#.\  ....#..*. ...#... ...#.\  ....#..*. ...#... ...#.\  ....#..* #
##........ ...#.. #....#.#\#........ ...#.. #....#.#\#........ ...#.. #....#.#\#........ ...#.. #....#.#\\#
#.....*... .....*\#\\.....*.....*... .....*\#\\.....*.....*... .....*\#\\.....*.....*... .....*\#\\.....*.#
#.***.* .......*\****.....#.***.* .......*\****.....#.***.* .......*\****.....#.***.* .......*\****.....#.#
#.\\\.. ................   .\\\.. ................   .\\\.. ................   .\\\.. ................   .#
#.#####    .######    #####.#####    .######    #####.#####    .######    #####.#####    .######    ##### #
#....\\........................\\........................\\........................\\.................... #
#....****...#.##.....\\\\......****...#.##.....\\\\......****...#.##.....\\\\......****...#.##.....\\\\..\#
#....\\\\...#.........*........\\\\...#.........*........\\\\...#.........*........\\\\...#.........*....\#
#....\\\\...#.\\.    #\###.....\\\\...#.\\.    #\###.....\\\\...#.\\.    #\###.....\\\\...#.\\.    #\###.\#
#....     ..#.... ...#\\\\.....     ..#.... ...#\\\\.....     ..#.... ...#\\\\.....     ..#.... ...#\\\\. #
#........ ..#.... ...#............. ..#.... ...#............. ..#.... ...#............. ..#.... ...#..... #
#........         ........#........         ........#........         ........#........         ........# #
#........................................................................................................\#
#..\\###...#....        ###..\\###...#....        ###..\\###...#....        ###..\\###...#....        ###.#
#..\*\\\.. #.... ..##\\..\#..\*\\\.. #.... ..##\\..\#..\*\\\.. #.... ..##\\..\#..\*\\\.. #.... ..##\\..\#.#
#..\*\.... #.... ..#\#....#..\*\.... #.... ..#\#....#..\*\.... #.... ..#\#....#..\*\.... #.... ..#\#....#.#
#...\###.. #.... ....#....#...\###.. #.... ....#....#...\###.. #.... ....#....#...\###.. #.... ....#....#.#
#... ..... ..... .####........ ..... ..... .####........ ..... ..... .####........ ..... ..... .####......#
#\\. #....           ......\\. #....           ......\\. #....           ......\\. #....           .......#
#... #..#. .....*\ ##......... #..#. .....*\ ##......... #..#. .....*\ ##......... #..#. .....*\ ##.......#
#.#....... ...#..  ....####.#....... ...#..  ....####.#....... ...#..  ....####.#....... ...#..  ....######
#. ...#... ...#.\  ....#..*. ...#... ...#.\  ....#..*. ...#... ...#.\  ....#..*. ...#... ...#.\  ....#..* #
##........ ...#.. #....#.#\#........ ...#.. #....#.#\#........ ...#.. #....#.#\#........ ...#.. #....#.#\\#
#.....*... .....*\#\\.....*.....*... .....*\#\\.....*.....*... .....*\#\\.....*.....*... .....*\#\\.....*.#
#.***.* .......*\****.....#.***.* .......*\****.....#.***.* .......*\****.....#.***.* .......*\****.....#.#
#.\\\.. ................   .\\\.. ................   .\\\.. ................   .\\\.. ................   .#
#.#####    .######    #####.#####    .######    #####.#####    .######    #####.#####    .######    ##### #
#....\\........................\\........................\\........................\\.................... #
#....****...#.##.....\\\\......****...#.##.....\\\\......****...#.##.....\\\\......****...#.##.....\\\\..\#
#....\\\\...#.........*........\\\\...#.........*........\\\\...#.........*........\\\\...#.........*....\#
#....\\\\...#.\\.    #\###.....\\\\...#.\\.    #\###.....\\\\...#.\\.    #\###.....\\\\...#.\\.    #\###.\#
#....     ..#.... ...#\\\\.....     ..#.... ...#\\\\.....     ..#.... ...#\\\\.....     ..#.... ...#\\\\. #
#........ ..#.... ...#............. ..#.... ...#............. ..#.... ...#............. ..#.... ...#..... #
#........         ........#........         ........#........         ........#........         ........# #
#........................................................................................................\#
#..\\###...#....        ###..\\###...#....        ###..\\###...#....        ###..\\###...#....        ###.#
#..\*\\\.. #.... ..##\\..\#..\*\\\.. #.... ..##\\..\#..\*\\\.. #.... ..##\\..\#..\*\\\.. #.... ..##\\..\#.#
#..\*\.... #.... ..#\#....#..\*\.... #.... ..#\#....#..\*\.... #.... ..#\#....#..\*\.... #.... ..#\#....#.#
#...\###.. #.... ....#....#...\###.. #.... ....#....#...\###.. #.... ....#....#...\###.. #.... ....#....#.#
#... ..... ..... .####........ ..... ..... .####........ ..... ..... .####........ ..... ..... .####......#
#\\. #....           ......\\. #....           ......\\. #....           ......\\. #....           .......#
#... #..#. .....*\ ##......... #..#. .....*\ ##......... #..#. .....*\ ##......... #..#. .....*\ ##.......#
#.#....... ...#..  ....####.#....... ...#..  ....####.#....... ...#..  ....####.#....... ...#..  ....######
#. ...#... ...#.\  ....#..*. ...#... ...#.\  ....#..*. ...#... ...#.\  ....#..*. ...#... ...#.\  ....#..* #
##........ ...#.. #....#.#\#........ ...#.. #....#.#\#........ ...#.. #....#.#\#........ ...#.. #....#.#\\#
#.....*... .....*\#\\.....*.....*... .....*\#\\.....*.....*... .....*\#\\.....*.....*... .....*\#\\.....*.#
#.***.* .......*\****.....#.***.* .......*\****.....#.***.* .......*\****.....#.***.* .......*\****.....#.#
#.\\\.. ................   .\\\.. ................   .\\\.. ................   .\\\.. ................   .#
#.#####    .######    #####.#####    .######    #####.#####    .######    #####.#####    .######    ##### #
#....\\........................\\........................\\........................\\.................... #
#....****...#.##.....\\\\......****...#.##.....\\\\......****...#.##.....\\\\......****...#.##.....\\\\..\#
#....\\\\...#.........*........\\\\...#.........*........\\\\...#.........*........\\\\...#.........*....\#
#....\\\\...#.\\.    #\###.....\\\\...#.\\.    #\###.....\\\\...#.\\.    #\###.....\\\\...#.\\.    #\###.\#
#....     ..#.... ...#\\\\.....     ..#.... ...#\\\\.....     ..#.... ...#\\\\.....     ..#.... ...#\\\\. #
#........ ..#.... ...#............. ..#.... ...#............. ..#.... ...#............. ..#.... ...#..... #
#........         ........#........         ........#........         ........#........         ........# #
#........................................................................................................\#
#..\\###...#....        ###..\\###...#....        ###..\\###...#....        ###..\\###...#....        ###.#
#..\*\\\.. #.... ..##\\..\#..\*\\\.. #.... ..##\\..\#..\*\\\.. #.... ..##\\..\#..\*\\\.. #.... ..##\\..\#.#
#..\*\.... #.... ..#\#....#..\*\.... #.... ..#\#....#..\*\.... #.... ..#\#....#..\*\.... #.... ..#\#....#.#
#...\###.. #.... ....#....#...\###.. #.... ....#....#...\###.. #.... ....#....#...\###.. #.... ....#....#.#
#... ..... ..... .####........ ..... ..... .####........ ..... ..... .####........ ..... ..... .####......#
#\\. #....           ......\\. #....           ......\\. #....           ......\\. #....           .......#
#... #..#. .....*\ ##......... #..#. .....*\ ##......... #..#. .....*\ ##......... #..#. .....*\ ##.......#
#.#....... ...#..  ....####.#....... ...#..  ....####.#....... ...#..  ....####.#....... ...#..  ....######
#. ...#... ...#.\  ....#..*. ...#... ...#.\  ....#..*. ...#... ...#.\  ....#..*. ...#... ...#.\  ....#..* #
##........ ...#.. #....#.#\#........ ...#.. #....#.#\#........ ...#.. #....#.#\#........ ...#.. #....#.#\\#
#.....*... .....*\#\\.....*.....*... .....*\#\\.....*.....*... .....*\#\\.....*.....*... .....*\#\\.....*.#
#.***.* .......*\****.....#.***.* .......*\****.....#.***.* .......*\****.....#.***.* .......*\****.....#.#
#.\\\.. ................   .\\\.. ................   .\\\.. ................   .\\\.. ................   .#
#.#####    .######    #####.#####    .######    #####.#####    .######    #####.#####    .######    ##### #
#....\\........................\\........................\\........................\\.................... #
#....****...#.##.....\\\\......****...#.##.....\\\\......****...#.##.....\\\\......****...#.##.....\\\\..\#
#....\\\\...#.........*........\\\\...#.........*........\\\\...#.........*........\\\\...#.........*....\#
#....\\\\...#.\\.    #\###.....\\\\...#.\\.    #\###.....\\\\...#.\\.    #\###.....\\\\...#.\\.    #\###.\#
#....     ..#.... ...#\\\\.....     ..#.... ...#\\\\.....     ..#.... ...#\\\\.....     ..#.... ...#\\\\. #
#........ ..#.... ...#............. ..#.... ...#............. ..#.... ...#............. ..#.... ...#..... #
#........         ........#........         ........#........         ........#........         ........# #
#........................................................................................................\#
#..\\###...#....        ###..\\###...#....        ###..\\###...#....        ###..\\###...#....        ###.#
#..\*\\\.. #.... ..##\\..\#..\*\\\.. #.... ..##\\..\#..\*\\\.. #.... ..##\\..\#..\*\\\.. #.... ..##\\..\#.#
#..\*\.... #.... ..#\#....#..\*\.... #.... ..#\#....#..\*\.... #.... ..#\#....#..\*\.... #.... ..#\#....#.#
#...\###.. #.... ....#....#...\###.. #.... ....#....#...\###.. #.... ....#....#...\###.. #.... ....#....#.#
#... ..... ..... .####........ ..... ..... .####........ ..... ..... .####........ ..... ..... .####......#
#\\. #....           ......\\. #....           ......\\. #....           ......\\. #....           .......#
#... #..#. .....*\ ##......... #..#. .....*\ ##......... #..#. .....*\ ##......... #..#. .....*\ ##.......#
#.#....... ...#..  ....####.#....... ...#..  ....####.#....... ...#..  ....####.#....... ...#..  ....######
#. ...#... ...#.\  ....#..*. ...#... ...#.\  ....#..*. ...#... ...#.\  ....#..*. ...#... ...#.\  ....#..* #
##........ ...#.. #....#.#\#........ ...#.. #....#.#\#........ ...#.. #....#.#\#........ ...#.. #....#.#\\#
#.....*... .....*\#\\.....*.....*... .....*\#\\.....*.....*... .....*\#\\.....*.....*... .....*\#\\.....*.#
#.***.* .......*\****.....#.***.* .......*\****.....#.***.* .......*\****.....#.***.* .......*\****.....#.#
#.\\\.. ................   .\\\.. ................   .\\\.. ................   .\\\.. ................   .#
#.#####    .######    #####.#####    .######    #####.#####    .######    #####.#####    .######    ##### #
#....\\........................\\........................\\........................\\.................... #
#....****...#.##.....\\\\......****...#.##.....\\\\......****...#.##.....\\\\......****...#.##.....\\\\..\#
#....\\\\...#.........*........\\\\...#.........*........\\\\...#.........*........\\\\...#.........*....\#
#....\\\\...#.\\.    #\###.....\\\\...#.\\.    #\###.....\\\\...#.\\.    #\###.....\\\\...#.\\.    #\###.\#
#....     ..#.... ...#\\\\.....     ..#.... ...#\\\\.....     ..#.... ...#\\\\.....     ..#.... ...#\\\\. #
#........ ..#.... ...#............. ..#.... ...#............. ..#.... ...#............. ..#.... ...#..... #
#........         ........#........         ........#........         ........#........         ........#R#
#########################################################################################################L#