#############
#R  \       #
#           #
#           #
#           #
#         W #
##########L##

Razors 10
