##########################
#          \         L   #
#########       ##########
        #       #
        ####*####
        #.......#
#########      *##########
#             *....*R    #
#             ..  .#     #
#               **       #
##########################