###############
#R...........L#
#.*..........*#
#######*#######
#......*......#
#..*......**..#
#.............#
#\*\...**.....#
###############